-----DUNGEON------
active_room - x: 2, y: 3
   [1][2][3][4][5]
[1][r][r][e][r][ ]
[2][r][r][r][r][r]
[3][r][s][r][r][ ]
[4][r][r][r][r][ ]
[5][r][r][r][ ][ ]
